w                  w
w                  w
wwwww          wwwww
w                  w
w        ww        w
w                  w
w                  w
w  ww  w     w  ww w
w   w  w e   w  w  w
w   w  wwwwwww  w  w
w   w           w  w
ww       P        ww
w    wwwwwwwwww    w
w        e         w
wwwwwwwwwwwwwwwwwwww
